20  8

. . . . . . . . . .
. G . . W . . . . .
. . . . W . . . . .
. . . . W . . . . .
. W W . W . . . . .
. . . . . . . . . .
. . . . W . . . . .
. . . . W . . . . P